*PWR ON at 29:
#define RAW_DATA_LEN 60
uint16_t rawData[RAW_DATA_LEN]={
	8418, 4242, 506, 1602, 506, 554, 526, 526, 
	530, 526, 530, 1578, 502, 554, 526, 526, 
	530, 526, 530, 526, 526, 526, 530, 526, 
	530, 522, 530, 526, 530, 526, 530, 526, 
	526, 526, 530, 1578, 502, 1606, 506, 1602, 
	506, 550, 530, 526, 530, 1578, 502, 554, 
	526, 530, 526, 526, 530, 526, 530, 1578, 
	502, 554, 526, 1000};

*PWR OFF:
#define RAW_DATA_LEN 60
uint16_t rawData[RAW_DATA_LEN]={
	8422, 4238, 506, 1606, 502, 554, 526, 526, 
	530, 526, 530, 1578, 502, 554, 526, 530, 
	526, 526, 530, 1578, 502, 1606, 506, 550, 
	530, 526, 530, 526, 526, 526, 530, 526, 
	530, 522, 530, 526, 530, 526, 526, 526, 
	530, 526, 530, 526, 526, 1582, 502, 550, 
	530, 1578, 506, 550, 530, 526, 530, 526, 
	526, 1582, 502, 1000};

*AUTO SWING (on/off):
#define RAW_DATA_LEN 60
uint16_t rawData[RAW_DATA_LEN]={
	8418, 4242, 506, 1606, 502, 554, 502, 554, 
	498, 554, 502, 1606, 506, 550, 502, 554, 
	498, 554, 502, 554, 502, 554, 498, 554, 
	502, 1606, 502, 554, 502, 554, 498, 554, 
	502, 554, 502, 554, 498, 554, 502, 554, 
	502, 550, 502, 554, 502, 554, 498, 554, 
	502, 554, 502, 554, 498, 554, 502, 554, 
	502, 1606, 502, 1000};

*TURBO ON:
#define RAW_DATA_LEN 60
uint16_t rawData[RAW_DATA_LEN]={
	8418, 4238, 506, 1606, 502, 554, 502, 554, 
	502, 554, 498, 1606, 502, 554, 502, 554, 
	502, 554, 518, 534, 502, 554, 502, 554, 
	498, 1606, 506, 550, 502, 554, 502, 554, 
	522, 530, 510, 546, 518, 538, 522, 530, 
	522, 534, 502, 1606, 502, 554, 502, 550, 
	522, 534, 510, 1598, 502, 554, 502, 554, 
	518, 1586, 502, 1000};

*TURBO OFF:
#define RAW_DATA_LEN 60
uint16_t rawData[RAW_DATA_LEN]={
	8418, 4242, 502, 1610, 502, 554, 498, 554, 
	502, 554, 502, 1606, 502, 554, 502, 550, 
	502, 554, 502, 554, 498, 554, 502, 554, 
	502, 554, 498, 1606, 506, 550, 502, 554, 
	502, 554, 502, 550, 502, 554, 502, 1606, 
	502, 1606, 502, 554, 502, 1606, 502, 554, 
	502, 554, 498, 1610, 502, 1606, 502, 1606, 
	502, 1606, 502, 1000};

*FAN LVL3:
#define RAW_DATA_LEN 60
uint16_t rawData[RAW_DATA_LEN]={
	8446, 4210, 538, 1574, 534, 522, 534, 522, 
	530, 522, 534, 1574, 538, 518, 534, 522, 
	534, 522, 530, 522, 534, 522, 534, 518, 
	534, 522, 534, 1574, 534, 522, 534, 522, 
	530, 522, 534, 1574, 538, 518, 534, 522, 
	534, 518, 534, 522, 534, 1574, 534, 522, 
	534, 522, 534, 518, 534, 1574, 538, 518, 
	538, 518, 534, 1000};

*TEMP 29:
#define RAW_DATA_LEN 60
uint16_t rawData[RAW_DATA_LEN]={
	8450, 4210, 538, 1574, 534, 522, 530, 522, 
	534, 522, 534, 1574, 534, 522, 534, 522, 
	530, 522, 534, 522, 530, 526, 530, 522, 
	534, 522, 530, 1578, 534, 522, 530, 522, 
	534, 522, 530, 1578, 534, 1574, 534, 1574, 
	538, 518, 534, 522, 530, 1578, 534, 522, 
	530, 522, 534, 1574, 538, 518, 534, 1574, 
	534, 522, 534, 1000};
*TEMP 28:
#define RAW_DATA_LEN 60
uint16_t rawData[RAW_DATA_LEN]={
	8446, 4214, 530, 1582, 526, 530, 530, 522, 
	530, 526, 526, 1582, 526, 530, 526, 526, 
	530, 526, 530, 526, 526, 526, 530, 526, 
	526, 530, 526, 1578, 530, 526, 530, 526, 
	530, 526, 526, 1582, 526, 1582, 526, 530, 
	526, 1582, 526, 530, 526, 1582, 526, 530, 
	526, 526, 530, 1578, 530, 526, 530, 526, 
	526, 1582, 526, 1000};
*TEMP 27:
#define RAW_DATA_LEN 60
uint16_t rawData[RAW_DATA_LEN]={
	8446, 4210, 534, 1578, 530, 526, 530, 526, 
	530, 526, 526, 1578, 530, 526, 530, 526, 
	530, 526, 526, 526, 530, 526, 530, 526, 
	526, 526, 530, 1578, 530, 526, 530, 526, 
	526, 526, 530, 1578, 530, 1582, 526, 530, 
	526, 526, 530, 526, 526, 1582, 526, 530, 
	526, 526, 530, 1578, 530, 526, 530, 526, 
	526, 526, 530, 1000};
*TEMP 26:
#define RAW_DATA_LEN 60
uint16_t rawData[RAW_DATA_LEN]={
	8442, 4214, 530, 1582, 530, 526, 530, 526, 
	526, 530, 526, 1578, 530, 526, 530, 526, 
	526, 530, 526, 526, 530, 526, 526, 530, 
	526, 526, 530, 1578, 530, 526, 526, 530, 
	526, 526, 530, 1578, 530, 526, 526, 1582, 
	530, 1578, 530, 526, 530, 1578, 530, 526, 
	526, 530, 526, 530, 526, 1578, 530, 1582, 
	526, 1582, 526, 1000};